#Scandinavia
NRL = "countries/Norrland.txt"
NID = "countries/Trodenlag.txt"
DSB = "countries/Danishsword.txt"

#Balkans
TRQ = "countries/Taraqia.txt"
SBY = "countries/Srbyaan.txt"
HUM = "countries/Hum.txt"
BUS = "countries/Busna.txt"
TRN = "countries/Torontal.txt"
VRS = "countries/Varasd.txt"
PST = "countries/Pest.txt"
ILY = "countries/Illyria.txt"
NIQ = "countries/Niqya.txt"

#British Isles
LNC = "countries/Lancaster.txt"
EAN = "countries/EastAnglia.txt"
SSX = "countries/Sussex.txt"
BRD = "countries/Bretland.txt"
BRL = "countries/Celtica.txt"
NSX = "countries/NewSaxony.txt"

#Eastern Europe
TUP = "countries/Minsk.txt"
YER = "countries/Yerevan.txt"

#France
STG	= "countries/Saintonge.txt"
QST = "countries/Qastany.txt"
TEM = "countries/Templar.txt"

#Spain
ALJ = "countries/Alentejo.txt"
TUL = "countries/Tulaytullah.txt" #toledo
MJT = "countries/Majrit.txt" #madrid
BLS = "countries/Balansiyah.txt" #valencia
BSL = "countries/Barshaluna.txt" #bercelona
IDS = "countries/Idrisids.txt"
SKS = "countries/Saksuns.txt"
MOZ = "countries/Mozarabia.txt"

#Italy
NAB = "countries/Nabuli.txt"
RMA = "countries/Ruma.txt"
KLB = "countries/Kalabria.txt"
SLT = "countries/Salintu.txt"
SQL = "countries/Siqily.txt"
IIT = "countries/Iitalia.txt"
LAT = "countries/Latin.txt"

#Russia
VPS = "countries/Veps.txt"
VLD = "countries/Vladimir.txt"

#Arabia
CAF = "countries/Caliphate.txt"
CAI = "countries/Qahirah.txt"

#New World
ABM = "countries/Al-Abama.txt"